UPWARD	AH P W ER D
DOWN	D AW N
LEFT	L EH F T
RIGHT	R AY T
ENTER	EH N ER
ENTER(2)	EH N T ER
BACK	B AE K
QUIT	K W IH T
PREVIOUS	P R IY V IY AH S
ANNOUNCE	AH N AW N S
MAP	M AE P
BOOKMARK	B UH K M AA R K
TOWN	T AW N
SCREEN	S K R IY N
FAR	F AA R
CLOSE	K L OW S
CLOSE(2)	K L OW Z
FORWARD	F AO R W ER D
ESCAPE	IH S K EY P
DIRECTION	D AY R EH K SH IH N
DIRECTION(2)	D ER EH K SH AH N
DIRECTION(3)	D IH R EH K SH IH N
DIRECTION(4)	D IY R EH K SH IH N
VIEW	V Y UW
